00000000000000
00400000000000
00000000040000
00000000000000
00000000000002
00000000000012
00000000000022
11111111111122
22322222222222
