000000000000000000111000000000000000000000000001
000000000000000022222000000000000000000000000112
000000000000000000000000100000000000000000000001
000000000000000011100000000000000000000000000000
000000000000000022200000000000000000000000000000
000000000000000023200000000000000000000000000000
000000000000000022200000000000000000000000000000
000000000000000022200000000000000000000000000000
100000111111111000000000000000100010000000000001
111111222222222111111111111112211121111111111112
222222222222222223222222323232222232222222222222
222222222222222222222222222222222222222222222222
