000000000000000
004000000000000
000000000400000
000000000000000
0000000000000d1
00001D0000d11c2
00002CD00dc0000
111122C11c211D0
2232222222222C1
