000000000000000000000000000000000000000000000000
000000000000000000000000000000000000000000000000
000000000000000000000000100000000000000000000000
000000000000000011100000000000000000000000000000
100000111111111000000000000000000010000000000000
011100000000000000000000000000000000000000000000
000000000000000000000000000000000000000000000000
