000000000000000000000000000000000
004000000000000000000000000000000
000000000400000000000000000000000
000000000000000000000011000000000
0000000000000d1000000000000000000
00001D0000d11c200000000000001D000
00002CD00dc2000000000000000002D00
111122C11c221D0000000000000000100
2232222222222C1000000000000000000
000000000000000000000000000000000
000000000000000000000000000000000
0000000000000000001100000000000000
000000000000000000220000d00000000
00000000000000000000000d200000000
0000000000000000000000d2000000000
0000000000001111111111c0000000000
000000000000222222222200000000000
000000000000000000000000000000000
111111111100000000000000000000000
